#####
# # #
# # #
#   #
#####
