   #   #   


#  ## ##  #
   #   #

   #   #
#  ## ##  #


   #   #   
